1111111111
10000000011
10E0000P1
1000000001
1111111111