1111111111
1000000001
10E00C0P01
1000000001
1111111111
