1111111111
1000000001
10E0080P01
1000C00001
1111111111