1111111111
10000001C1
10E0000011
10000P0001
1111111111