00000000000000110000000000000000000
00011111001111001000000000000000000
00100C0011000000E100001111100000000
0100CC00C00000001000110000011100000
0010CC00000000000111000000000010000
0010000111000000000000001110P010000
00011110001111111111111100011100000
00000000000000000000000000000000000