1111111111111
1P010000000C1
1PP0011111001
1PPP11E000001
1111111111111